Converting to Pandas dataframes
One convenience of doing SQL from Python is that we can directly use Python commands on the data that we extract from a database using SQL. For example, we can extract a data table from the database using SQL and then convert it to a Pandas data frame as shown below. From here, we can use any Python commands that we like.

dbout = %sql select CustomerId, InvoiceDate,BillingPostalCode,total from invoices where Total<5
db1=dbout.DataFrame()  #converting to Pandas dataframe 
 * sqlite:///chinook.db
Done.
db1
CustomerId	InvoiceDate	BillingPostalCode	Total
0	2	2009-01-01 00:00:00	70174	1.98
1	4	2009-01-02 00:00:00	0171	3.96
2	37	2009-01-19 00:00:00	60316	0.99
3	38	2009-02-01 00:00:00	10779	1.98
4	40	2009-02-01 00:00:00	75002	1.98
...	...	...	...	...
228	20	2013-11-21 00:00:00	94040-111	0.99
229	21	2013-12-04 00:00:00	89503	1.98
230	23	2013-12-04 00:00:00	2113	1.98
231	25	2013-12-05 00:00:00	53703	3.96
232	58	2013-12-22 00:00:00	110017	1.99
233 rows × 4 columns

import numpy as np

np.mean(db1.Total)
np.max(db1.Total)
3.98
Different Types of SQL JOINs
Here are the different types of the JOINs in SQL:

(INNER) JOIN: Returns records that have matching values in both tables
LEFT (OUTER) JOIN: Returns all records from the left table, and the matched records from the right table
RIGHT (OUTER) JOIN: Returns all records from the right table, and the matched records from the left table
FULL (OUTER) JOIN: Returns all records when there is a match in either left or right table

Inner join
In the example below, the INNER JOIN clause matches each row from the albums table with every row from the artists table based on the join condition (artists.ArtistId = albums.ArtistId) specified after the ON keyword.

%%sql

SELECT
    l.Title, 
    r.Name
FROM
    albums l
INNER JOIN artists r ON
    r.ArtistId = l.ArtistId;
 * sqlite:///chinook.db
Done.
Title	Name
For Those About To Rock We Salute You	AC/DC
Balls to the Wall	Accept
Restless and Wild	Accept
Let There Be Rock	AC/DC
Big Ones	Aerosmith
Jagged Little Pill	Alanis Morissette
Facelift	Alice In Chains
Warner 25 Anos	Antônio Carlos Jobim
Plays Metallica By Four Cellos	Apocalyptica
Audioslave	Audioslave
Out Of Exile	Audioslave
BackBeat Soundtrack	BackBeat
The Best Of Billy Cobham	Billy Cobham
Alcohol Fueled Brewtality Live! [Disc 1]	Black Label Society
Alcohol Fueled Brewtality Live! [Disc 2]	Black Label Society
Black Sabbath	Black Sabbath
Black Sabbath Vol. 4 (Remaster)	Black Sabbath
Body Count	Body Count
Chemical Wedding	Bruce Dickinson
The Best Of Buddy Guy - The Millenium Collection	Buddy Guy
Prenda Minha	Caetano Veloso
Sozinho Remix Ao Vivo	Caetano Veloso
Minha Historia	Chico Buarque
Afrociberdelia	Chico Science & Nação Zumbi
Da Lama Ao Caos	Chico Science & Nação Zumbi
Acústico MTV [Live]	Cidade Negra
Cidade Negra - Hits	Cidade Negra
Na Pista	Cláudio Zoli
Axé Bahia 2001	Various Artists
BBC Sessions [Disc 1] [Live]	Led Zeppelin
Bongo Fury	Frank Zappa & Captain Beefheart
Carnaval 2001	Various Artists
Chill: Brazil (Disc 1)	Marcos Valle
Chill: Brazil (Disc 2)	Antônio Carlos Jobim
Garage Inc. (Disc 1)	Metallica
Greatest Hits II	Queen
Greatest Kiss	Kiss
Heart of the Night	Spyro Gyra
International Superhits	Green Day
Into The Light	David Coverdale
Meus Momentos	Gonzaguinha
Minha História	Os Mutantes
MK III The Final Concerts [Disc 1]	Deep Purple
Physical Graffiti [Disc 1]	Led Zeppelin
Sambas De Enredo 2001	Various Artists
Supernatural	Santana
The Best of Ed Motta	Ed Motta
The Essential Miles Davis [Disc 1]	Miles Davis
The Essential Miles Davis [Disc 2]	Miles Davis
The Final Concerts (Disc 2)	Deep Purple
Up An' Atom	Gene Krupa
Vinícius De Moraes - Sem Limite	Toquinho & Vinícius
Vozes do MPB	Various Artists
Chronicle, Vol. 1	Creedence Clearwater Revival
Chronicle, Vol. 2	Creedence Clearwater Revival
Cássia Eller - Coleção Sem Limite [Disc 2]	Cássia Eller
Cássia Eller - Sem Limite [Disc 1]	Cássia Eller
Come Taste The Band	Deep Purple
Deep Purple In Rock	Deep Purple
Fireball	Deep Purple
Knocking at Your Back Door: The Best Of Deep Purple in the 80's	Deep Purple
Machine Head	Deep Purple
Purpendicular	Deep Purple
Slaves And Masters	Deep Purple
Stormbringer	Deep Purple
The Battle Rages On	Deep Purple
Vault: Def Leppard's Greatest Hits	Def Leppard
Outbreak	Dennis Chambers
Djavan Ao Vivo - Vol. 02	Djavan
Djavan Ao Vivo - Vol. 1	Djavan
Elis Regina-Minha História	Elis Regina
The Cream Of Clapton	Eric Clapton
Unplugged	Eric Clapton
Album Of The Year	Faith No More
Angel Dust	Faith No More
King For A Day Fool For A Lifetime	Faith No More
The Real Thing	Faith No More
Deixa Entrar	Falamansa
In Your Honor [Disc 1]	Foo Fighters
In Your Honor [Disc 2]	Foo Fighters
One By One	Foo Fighters
The Colour And The Shape	Foo Fighters
My Way: The Best Of Frank Sinatra [Disc 1]	Frank Sinatra
Roda De Funk	Funk Como Le Gusta
As Canções de Eu Tu Eles	Gilberto Gil
Quanta Gente Veio Ver (Live)	Gilberto Gil
Quanta Gente Veio ver--Bônus De Carnaval	Gilberto Gil
Faceless	Godsmack
American Idiot	Green Day
Appetite for Destruction	Guns N' Roses
Use Your Illusion I	Guns N' Roses
Use Your Illusion II	Guns N' Roses
Blue Moods	Incognito
A Matter of Life and Death	Iron Maiden
A Real Dead One	Iron Maiden
A Real Live One	Iron Maiden
Brave New World	Iron Maiden
Dance Of Death	Iron Maiden
Fear Of The Dark	Iron Maiden
Iron Maiden	Iron Maiden
Killers	Iron Maiden
Live After Death	Iron Maiden
Live At Donington 1992 (Disc 1)	Iron Maiden
Live At Donington 1992 (Disc 2)	Iron Maiden
No Prayer For The Dying	Iron Maiden
Piece Of Mind	Iron Maiden
Powerslave	Iron Maiden
Rock In Rio [CD1]	Iron Maiden
Rock In Rio [CD2]	Iron Maiden
Seventh Son of a Seventh Son	Iron Maiden
Somewhere in Time	Iron Maiden
The Number of The Beast	Iron Maiden
The X Factor	Iron Maiden
Virtual XI	Iron Maiden
Sex Machine	James Brown
Emergency On Planet Earth	Jamiroquai
Synkronized	Jamiroquai
The Return Of The Space Cowboy	Jamiroquai
Get Born	JET
Are You Experienced?	Jimi Hendrix
Surfing with the Alien (Remastered)	Joe Satriani
Jorge Ben Jor 25 Anos	Jorge Ben
Jota Quest-1995	Jota Quest
Cafezinho	João Suplicy
Living After Midnight	Judas Priest
Unplugged [Live]	Kiss
BBC Sessions [Disc 2] [Live]	Led Zeppelin
Coda	Led Zeppelin
Houses Of The Holy	Led Zeppelin
In Through The Out Door	Led Zeppelin
IV	Led Zeppelin
Led Zeppelin I	Led Zeppelin
Led Zeppelin II	Led Zeppelin
Led Zeppelin III	Led Zeppelin
Physical Graffiti [Disc 2]	Led Zeppelin
Presence	Led Zeppelin
The Song Remains The Same (Disc 1)	Led Zeppelin
The Song Remains The Same (Disc 2)	Led Zeppelin
A TempestadeTempestade Ou O Livro Dos Dias	Legião Urbana
Mais Do Mesmo	Legião Urbana
Greatest Hits	Lenny Kravitz
Lulu Santos - RCA 100 Anos De Música - Álbum 01	Lulu Santos
Lulu Santos - RCA 100 Anos De Música - Álbum 02	Lulu Santos
Misplaced Childhood	Marillion
Barulhinho Bom	Marisa Monte
Seek And Shall Find: More Of The Best (1963-1981)	Marvin Gaye
The Best Of Men At Work	Men At Work
Black Album	Metallica
Garage Inc. (Disc 2)	Metallica
Kill 'Em All	Metallica
Load	Metallica
Master Of Puppets	Metallica
ReLoad	Metallica
Ride The Lightning	Metallica
St. Anger	Metallica
...And Justice For All	Metallica
Miles Ahead	Miles Davis
Milton Nascimento Ao Vivo	Milton Nascimento
Minas	Milton Nascimento
Ace Of Spades	Motörhead
Demorou...	Mônica Marianno
Motley Crue Greatest Hits	Mötley Crüe
From The Muddy Banks Of The Wishkah [Live]	Nirvana
Nevermind	Nirvana
Compositores	O Terço
Olodum	Olodum
Acústico MTV	Os Paralamas Do Sucesso
Arquivo II	Os Paralamas Do Sucesso
Arquivo Os Paralamas Do Sucesso	Os Paralamas Do Sucesso
Bark at the Moon (Remastered)	Ozzy Osbourne
Blizzard of Ozz	Ozzy Osbourne
Diary of a Madman (Remastered)	Ozzy Osbourne
No More Tears (Remastered)	Ozzy Osbourne
Tribute	Ozzy Osbourne
Walking Into Clarksdale	Page & Plant
Original Soundtracks 1	Passengers
The Beast Live	Paul D'Ianno
Live On Two Legs [Live]	Pearl Jam
Pearl Jam	Pearl Jam
Riot Act	Pearl Jam
Ten	Pearl Jam
Vs.	Pearl Jam
Dark Side Of The Moon	Pink Floyd
Os Cães Ladram Mas A Caravana Não Pára	Planet Hemp
Greatest Hits I	Queen
News Of The World	Queen
Out Of Time	R.E.M. Feat. Kate Pearson
Green	R.E.M.
New Adventures In Hi-Fi	R.E.M.
The Best Of R.E.M.: The IRS Years	R.E.M.
Cesta Básica	Raimundos
Raul Seixas	Raul Seixas
Blood Sugar Sex Magik	Red Hot Chili Peppers
By The Way	Red Hot Chili Peppers
Californication	Red Hot Chili Peppers
Retrospective I (1974-1980)	Rush
Santana - As Years Go By	Santana
Santana Live	Santana
Maquinarama	Skank
O Samba Poconé	Skank
Judas 0: B-Sides and Rarities	Smashing Pumpkins
Rotten Apples: Greatest Hits	Smashing Pumpkins
A-Sides	Soundgarden
Morning Dance	Spyro Gyra
In Step	Stevie Ray Vaughan & Double Trouble
Core	Stone Temple Pilots
Mezmerize	System Of A Down
[1997] Black Light Syndrome	Terry Bozzio, Tony Levin & Steve Stevens
Live [Disc 1]	The Black Crowes
Live [Disc 2]	The Black Crowes
The Singles	The Clash
Beyond Good And Evil	The Cult
Pure Cult: The Best Of The Cult (For Rockers, Ravers, Lovers & Sinners) [UK]	The Cult
The Doors	The Doors
The Police Greatest Hits	The Police
Hot Rocks, 1964-1971 (Disc 1)	The Rolling Stones
No Security	The Rolling Stones
Voodoo Lounge	The Rolling Stones
Tangents	The Tea Party
Transmission	The Tea Party
My Generation - The Very Best Of The Who	The Who
Serie Sem Limite (Disc 1)	Tim Maia
Serie Sem Limite (Disc 2)	Tim Maia
Acústico	Titãs
Volume Dois	Titãs
Battlestar Galactica: The Story So Far	Battlestar Galactica
Battlestar Galactica, Season 3	Battlestar Galactica
Heroes, Season 1	Heroes
Lost, Season 3	Lost
Lost, Season 1	Lost
Lost, Season 2	Lost
Achtung Baby	U2
All That You Can't Leave Behind	U2
B-Sides 1980-1990	U2
How To Dismantle An Atomic Bomb	U2
Pop	U2
Rattle And Hum	U2
The Best Of 1980-1990	U2
War	U2
Zooropa	U2
UB40 The Best Of - Volume Two [UK]	UB40
Diver Down	Van Halen
The Best Of Van Halen, Vol. I	Van Halen
Van Halen	Van Halen
Van Halen III	Van Halen
Contraband	Velvet Revolver
Vinicius De Moraes	Vinícius De Moraes
Ao Vivo [IMPORT]	Zeca Pagodinho
The Office, Season 1	The Office
The Office, Season 2	The Office
The Office, Season 3	The Office
Un-Led-Ed	Dread Zeppelin
Battlestar Galactica (Classic), Season 1	Battlestar Galactica (Classic)
Aquaman	Aquaman
Instant Karma: The Amnesty International Campaign to Save Darfur	U2
Speak of the Devil	Ozzy Osbourne
20th Century Masters - The Millennium Collection: The Best of Scorpions	Scorpions
House of Pain	House Of Pain
Radio Brasil (O Som da Jovem Vanguarda) - Seleccao de Henrique Amaro	O Rappa
Cake: B-Sides and Rarities	Cake
LOST, Season 4	Lost
Quiet Songs	Aisha Duo
Muso Ko	Habib Koité and Bamada
Realize	Karsh Kale
Every Kind of Light	The Posies
Duos II	Luciana Souza/Romero Lubambo
Worlds	Aaron Goldberg
The Best of Beethoven	Nicolaus Esterhazy Sinfonia
Temple of the Dog	Temple of the Dog
Carry On	Chris Cornell
Revelations	Audioslave
Adorate Deum: Gregorian Chant from the Proper of the Mass	Alberto Turco & Nova Schola Gregoriana
Allegri: Miserere	Richard Marlow & The Choir of Trinity College, Cambridge
Pachelbel: Canon & Gigue	English Concert & Trevor Pinnock
Vivaldi: The Four Seasons	Anne-Sophie Mutter, Herbert Von Karajan & Wiener Philharmoniker
Bach: Violin Concertos	Hilary Hahn, Jeffrey Kahane, Los Angeles Chamber Orchestra & Margaret Batjer
Bach: Goldberg Variations	Wilhelm Kempff
Bach: The Cello Suites	Yo-Yo Ma
Handel: The Messiah (Highlights)	Scholars Baroque Ensemble
The World of Classical Favourites	Academy of St. Martin in the Fields & Sir Neville Marriner
Sir Neville Marriner: A Celebration	Academy of St. Martin in the Fields Chamber Ensemble & Sir Neville Marriner
Mozart: Wind Concertos	Berliner Philharmoniker, Claudio Abbado & Sabine Meyer
Haydn: Symphonies 99 - 104	Royal Philharmonic Orchestra & Sir Thomas Beecham
Beethoven: Symhonies Nos. 5 & 6	Orchestre Révolutionnaire et Romantique & John Eliot Gardiner
A Soprano Inspired	Britten Sinfonia, Ivor Bolton & Lesley Garrett
Great Opera Choruses	Chicago Symphony Chorus, Chicago Symphony Orchestra & Sir Georg Solti
Wagner: Favourite Overtures	Sir Georg Solti & Wiener Philharmoniker
Fauré: Requiem, Ravel: Pavane & Others	Academy of St. Martin in the Fields, John Birch, Sir Neville Marriner & Sylvia McNair
Tchaikovsky: The Nutcracker	London Symphony Orchestra & Sir Charles Mackerras
The Last Night of the Proms	Barry Wordsworth & BBC Concert Orchestra
Puccini: Madama Butterfly - Highlights	Herbert Von Karajan, Mirella Freni & Wiener Philharmoniker
Holst: The Planets, Op. 32 & Vaughan Williams: Fantasies	Eugene Ormandy
Pavarotti's Opera Made Easy	Luciano Pavarotti
Great Performances - Barber's Adagio and Other Romantic Favorites for Strings	Leonard Bernstein & New York Philharmonic
Carmina Burana	Boston Symphony Orchestra & Seiji Ozawa
A Copland Celebration, Vol. I	Aaron Copland & London Symphony Orchestra
Bach: Toccata & Fugue in D Minor	Ton Koopman
Prokofiev: Symphony No.1	Sergei Prokofiev & Yuri Temirkanov
Scheherazade	Chicago Symphony Orchestra & Fritz Reiner
Bach: The Brandenburg Concertos	Orchestra of The Age of Enlightenment
Chopin: Piano Concertos Nos. 1 & 2	Emanuel Ax, Eugene Ormandy & Philadelphia Orchestra
Mascagni: Cavalleria Rusticana	James Levine
Sibelius: Finlandia	Berliner Philharmoniker & Hans Rosbaud
Beethoven Piano Sonatas: Moonlight & Pastorale	Maurizio Pollini
Great Recordings of the Century - Mahler: Das Lied von der Erde	Gustav Mahler
Elgar: Cello Concerto & Vaughan Williams: Fantasias	Felix Schmidt, London Symphony Orchestra & Rafael Frühbeck de Burgos
Adams, John: The Chairman Dances	Edo de Waart & San Francisco Symphony
Tchaikovsky: 1812 Festival Overture, Op.49, Capriccio Italien & Beethoven: Wellington's Victory	Antal Doráti & London Symphony Orchestra
Palestrina: Missa Papae Marcelli & Allegri: Miserere	Choir Of Westminster Abbey & Simon Preston
Prokofiev: Romeo & Juliet	Michael Tilson Thomas & San Francisco Symphony
Strauss: Waltzes	Eugene Ormandy
Berlioz: Symphonie Fantastique	Michael Tilson Thomas & San Francisco Symphony
Bizet: Carmen Highlights	Chor der Wiener Staatsoper, Herbert Von Karajan & Wiener Philharmoniker
English Renaissance	The King's Singers
Handel: Music for the Royal Fireworks (Original Version 1749)	English Concert & Trevor Pinnock
Grieg: Peer Gynt Suites & Sibelius: Pelléas et Mélisande	Berliner Philharmoniker & Herbert Von Karajan
Mozart Gala: Famous Arias	Sir Georg Solti, Sumi Jo & Wiener Philharmoniker
SCRIABIN: Vers la flamme	Christopher O'Riley
Armada: Music from the Courts of England and Spain	Fretwork
Mozart: Symphonies Nos. 40 & 41	Berliner Philharmoniker & Herbert Von Karajan
Back to Black	Amy Winehouse
Frank	Amy Winehouse
Carried to Dust (Bonus Track Version)	Calexico
Beethoven: Symphony No. 6 'Pastoral' Etc.	Otto Klemperer & Philharmonia Orchestra
Bartok: Violin & Viola Concertos	Yehudi Menuhin
Mendelssohn: A Midsummer Night's Dream	Philharmonia Orchestra & Sir Neville Marriner
Bach: Orchestral Suites Nos. 1 - 4	Academy of St. Martin in the Fields, Sir Neville Marriner & Thurston Dart
Charpentier: Divertissements, Airs & Concerts	Les Arts Florissants & William Christie
South American Getaway	The 12 Cellists of The Berlin Philharmonic
Górecki: Symphony No. 3	Adrian Leaper & Doreen de Feis
Purcell: The Fairy Queen	Roger Norrington, London Classical Players
The Ultimate Relexation Album	Charles Dutoit & L'Orchestre Symphonique de Montréal
Purcell: Music for the Queen Mary	Equale Brass Ensemble, John Eliot Gardiner & Munich Monteverdi Orchestra and Choir
Weill: The Seven Deadly Sins	Kent Nagano and Orchestre de l'Opéra de Lyon
J.S. Bach: Chaconne, Suite in E Minor, Partita in E Major & Prelude, Fugue and Allegro	Julian Bream
Prokofiev: Symphony No.5 & Stravinksy: Le Sacre Du Printemps	Berliner Philharmoniker & Herbert Von Karajan
Szymanowski: Piano Works, Vol. 1	Martin Roscoe
Nielsen: The Six Symphonies	Göteborgs Symfoniker & Neeme Järvi
Great Recordings of the Century: Paganini's 24 Caprices	Itzhak Perlman
Liszt - 12 Études D'Execution Transcendante	Michele Campanella
Great Recordings of the Century - Shubert: Schwanengesang, 4 Lieder	Gerald Moore
Locatelli: Concertos for Violin, Strings and Continuo, Vol. 3	Mela Tenenbaum, Pro Musica Prague & Richard Kapp
Respighi:Pines of Rome	Eugene Ormandy
Schubert: The Late String Quartets & String Quintet (3 CD's)	Emerson String Quartet
Monteverdi: L'Orfeo	C. Monteverdi, Nigel Rogers - Chiaroscuro; London Baroque; London Cornett & Sackbu
Mozart: Chamber Music	Nash Ensemble
Koyaanisqatsi (Soundtrack from the Motion Picture)	Philip Glass Ensemble
Left (outer) Join
This statement selects the artist names and album titles from the artists and albums tables using the LEFT JOIN clause:

%%sql

SELECT
    Name, 
    Title
FROM
    artists
LEFT JOIN albums ON
    artists.ArtistId = albums.ArtistId
ORDER BY Name;
 * sqlite:///chinook.db
Done.
Name	Title
A Cor Do Som	None
AC/DC	For Those About To Rock We Salute You
AC/DC	Let There Be Rock
Aaron Copland & London Symphony Orchestra	A Copland Celebration, Vol. I
Aaron Goldberg	Worlds
Academy of St. Martin in the Fields & Sir Neville Marriner	The World of Classical Favourites
Academy of St. Martin in the Fields Chamber Ensemble & Sir Neville Marriner	Sir Neville Marriner: A Celebration
Academy of St. Martin in the Fields, John Birch, Sir Neville Marriner & Sylvia McNair	Fauré: Requiem, Ravel: Pavane & Others
Academy of St. Martin in the Fields, Sir Neville Marriner & Thurston Dart	Bach: Orchestral Suites Nos. 1 - 4
Academy of St. Martin in the Fields, Sir Neville Marriner & William Bennett	None
Accept	Balls to the Wall
Accept	Restless and Wild
Adrian Leaper & Doreen de Feis	Górecki: Symphony No. 3
Aerosmith	Big Ones
Aerosmith & Sierra Leone's Refugee Allstars	None
Aisha Duo	Quiet Songs
Alanis Morissette	Jagged Little Pill
Alberto Turco & Nova Schola Gregoriana	Adorate Deum: Gregorian Chant from the Proper of the Mass
Alice In Chains	Facelift
Amy Winehouse	Back to Black
Amy Winehouse	Frank
Anne-Sophie Mutter, Herbert Von Karajan & Wiener Philharmoniker	Vivaldi: The Four Seasons
Antal Doráti & London Symphony Orchestra	Tchaikovsky: 1812 Festival Overture, Op.49, Capriccio Italien & Beethoven: Wellington's Victory
Antônio Carlos Jobim	Warner 25 Anos
Antônio Carlos Jobim	Chill: Brazil (Disc 2)
Apocalyptica	Plays Metallica By Four Cellos
Aquaman	Aquaman
Audioslave	Audioslave
Audioslave	Out Of Exile
Audioslave	Revelations
Avril Lavigne	None
Azymuth	None
Baby Consuelo	None
BackBeat	BackBeat Soundtrack
Banda Black Rio	None
Barry Wordsworth & BBC Concert Orchestra	The Last Night of the Proms
Barão Vermelho	None
Battlestar Galactica	Battlestar Galactica: The Story So Far
Battlestar Galactica	Battlestar Galactica, Season 3
Battlestar Galactica (Classic)	Battlestar Galactica (Classic), Season 1
Bebel Gilberto	None
Ben Harper	None
Berliner Philharmoniker & Hans Rosbaud	Sibelius: Finlandia
Berliner Philharmoniker & Herbert Von Karajan	Grieg: Peer Gynt Suites & Sibelius: Pelléas et Mélisande
Berliner Philharmoniker & Herbert Von Karajan	Mozart: Symphonies Nos. 40 & 41
Berliner Philharmoniker & Herbert Von Karajan	Prokofiev: Symphony No.5 & Stravinksy: Le Sacre Du Printemps
Berliner Philharmoniker, Claudio Abbado & Sabine Meyer	Mozart: Wind Concertos
Big & Rich	None
Billy Cobham	The Best Of Billy Cobham
Black Eyed Peas	None
Black Label Society	Alcohol Fueled Brewtality Live! [Disc 1]
Black Label Society	Alcohol Fueled Brewtality Live! [Disc 2]
Black Sabbath	Black Sabbath
Black Sabbath	Black Sabbath Vol. 4 (Remaster)
Body Count	Body Count
Boston Symphony Orchestra & Seiji Ozawa	Carmina Burana
Britten Sinfonia, Ivor Bolton & Lesley Garrett	A Soprano Inspired
Bruce Dickinson	Chemical Wedding
Buddy Guy	The Best Of Buddy Guy - The Millenium Collection
C. Monteverdi, Nigel Rogers - Chiaroscuro; London Baroque; London Cornett & Sackbu	Monteverdi: L'Orfeo
Caetano Veloso	Prenda Minha
Caetano Veloso	Sozinho Remix Ao Vivo
Cake	Cake: B-Sides and Rarities
Calexico	Carried to Dust (Bonus Track Version)
Charles Dutoit & L'Orchestre Symphonique de Montréal	The Ultimate Relexation Album
Charlie Brown Jr.	None
Chicago Symphony Chorus, Chicago Symphony Orchestra & Sir Georg Solti	Great Opera Choruses
Chicago Symphony Orchestra & Fritz Reiner	Scheherazade
Chico Buarque	Minha Historia
Chico Science & Nação Zumbi	Afrociberdelia
Chico Science & Nação Zumbi	Da Lama Ao Caos
Choir Of Westminster Abbey & Simon Preston	Palestrina: Missa Papae Marcelli & Allegri: Miserere
Chor der Wiener Staatsoper, Herbert Von Karajan & Wiener Philharmoniker	Bizet: Carmen Highlights
Chris Cornell	Carry On
Christina Aguilera featuring BigElf	None
Christopher O'Riley	SCRIABIN: Vers la flamme
Cidade Negra	Acústico MTV [Live]
Cidade Negra	Cidade Negra - Hits
Cláudio Zoli	Na Pista
Corinne Bailey Rae	None
Creedence Clearwater Revival	Chronicle, Vol. 1
Creedence Clearwater Revival	Chronicle, Vol. 2
Cássia Eller	Cássia Eller - Coleção Sem Limite [Disc 2]
Cássia Eller	Cássia Eller - Sem Limite [Disc 1]
DJ Dolores & Orchestra Santa Massa	None
David Coverdale	Into The Light
Deep Purple	MK III The Final Concerts [Disc 1]
Deep Purple	The Final Concerts (Disc 2)
Deep Purple	Come Taste The Band
Deep Purple	Deep Purple In Rock
Deep Purple	Fireball
Deep Purple	Knocking at Your Back Door: The Best Of Deep Purple in the 80's
Deep Purple	Machine Head
Deep Purple	Purpendicular
Deep Purple	Slaves And Masters
Deep Purple	Stormbringer
Deep Purple	The Battle Rages On
Def Leppard	Vault: Def Leppard's Greatest Hits
Dennis Chambers	Outbreak
Dhani Harrison & Jakob Dylan	None
Djavan	Djavan Ao Vivo - Vol. 02
Djavan	Djavan Ao Vivo - Vol. 1
Dread Zeppelin	Un-Led-Ed
Ed Motta	The Best of Ed Motta
Edo de Waart & San Francisco Symphony	Adams, John: The Chairman Dances
Edson, DJ Marky & DJ Patife Featuring Fernanda Porto	None
Elis Regina	Elis Regina-Minha História
Emanuel Ax, Eugene Ormandy & Philadelphia Orchestra	Chopin: Piano Concertos Nos. 1 & 2
Emerson String Quartet	Schubert: The Late String Quartets & String Quintet (3 CD's)
English Concert & Trevor Pinnock	Pachelbel: Canon & Gigue
English Concert & Trevor Pinnock	Handel: Music for the Royal Fireworks (Original Version 1749)
Equale Brass Ensemble, John Eliot Gardiner & Munich Monteverdi Orchestra and Choir	Purcell: Music for the Queen Mary
Eric Clapton	The Cream Of Clapton
Eric Clapton	Unplugged
Eugene Ormandy	Holst: The Planets, Op. 32 & Vaughan Williams: Fantasies
Eugene Ormandy	Strauss: Waltzes
Eugene Ormandy	Respighi:Pines of Rome
Faith No More	Album Of The Year
Faith No More	Angel Dust
Faith No More	King For A Day Fool For A Lifetime
Faith No More	The Real Thing
Falamansa	Deixa Entrar
Felix Schmidt, London Symphony Orchestra & Rafael Frühbeck de Burgos	Elgar: Cello Concerto & Vaughan Williams: Fantasias
Fernanda Porto	None
Foo Fighters	In Your Honor [Disc 1]
Foo Fighters	In Your Honor [Disc 2]
Foo Fighters	One By One
Foo Fighters	The Colour And The Shape
Frank Sinatra	My Way: The Best Of Frank Sinatra [Disc 1]
Frank Zappa & Captain Beefheart	Bongo Fury
Fretwork	Armada: Music from the Courts of England and Spain
Funk Como Le Gusta	Roda De Funk
Gene Krupa	Up An' Atom
Gerald Moore	Great Recordings of the Century - Shubert: Schwanengesang, 4 Lieder
Gilberto Gil	As Canções de Eu Tu Eles
Gilberto Gil	Quanta Gente Veio Ver (Live)
Gilberto Gil	Quanta Gente Veio ver--Bônus De Carnaval
Godsmack	Faceless
Gonzaguinha	Meus Momentos
Green Day	International Superhits
Green Day	American Idiot
Guns N' Roses	Appetite for Destruction
Guns N' Roses	Use Your Illusion I
Guns N' Roses	Use Your Illusion II
Gustav Mahler	Great Recordings of the Century - Mahler: Das Lied von der Erde
Gustavo & Andres Veiga & Salazar	None
Göteborgs Symfoniker & Neeme Järvi	Nielsen: The Six Symphonies
Habib Koité and Bamada	Muso Ko
Herbert Von Karajan, Mirella Freni & Wiener Philharmoniker	Puccini: Madama Butterfly - Highlights
Hermeto Pascoal	None
Heroes	Heroes, Season 1
Hilary Hahn, Jeffrey Kahane, Los Angeles Chamber Orchestra & Margaret Batjer	Bach: Violin Concertos
House Of Pain	House of Pain
Incognito	Blue Moods
Instituto	None
Iron Maiden	A Matter of Life and Death
Iron Maiden	A Real Dead One
Iron Maiden	A Real Live One
Iron Maiden	Brave New World
Iron Maiden	Dance Of Death
Iron Maiden	Fear Of The Dark
Iron Maiden	Iron Maiden
Iron Maiden	Killers
Iron Maiden	Live After Death
Iron Maiden	Live At Donington 1992 (Disc 1)
Iron Maiden	Live At Donington 1992 (Disc 2)
Iron Maiden	No Prayer For The Dying
Iron Maiden	Piece Of Mind
Iron Maiden	Powerslave
Iron Maiden	Rock In Rio [CD1]
Iron Maiden	Rock In Rio [CD2]
Iron Maiden	Seventh Son of a Seventh Son
Iron Maiden	Somewhere in Time
Iron Maiden	The Number of The Beast
Iron Maiden	The X Factor
Iron Maiden	Virtual XI
Itzhak Perlman	Great Recordings of the Century: Paganini's 24 Caprices
JET	Get Born
Jack Johnson	None
Jack's Mannequin & Mick Fleetwood	None
Jackson Browne	None
Jaguares	None
James Brown	Sex Machine
James Levine	Mascagni: Cavalleria Rusticana
Jamiroquai	Emergency On Planet Earth
Jamiroquai	Synkronized
Jamiroquai	The Return Of The Space Cowboy
Jimi Hendrix	Are You Experienced?
Joe Satriani	Surfing with the Alien (Remastered)
Jorge Ben	Jorge Ben Jor 25 Anos
Jorge Vercilo	None
Jota Quest	Jota Quest-1995
João Gilberto	None
João Suplicy	Cafezinho
Judas Priest	Living After Midnight
Julian Bream	J.S. Bach: Chaconne, Suite in E Minor, Partita in E Major & Prelude, Fugue and Allegro
Karsh Kale	Realize
Kent Nagano and Orchestre de l'Opéra de Lyon	Weill: The Seven Deadly Sins
Kid Abelha	None
Kiss	Greatest Kiss
Kiss	Unplugged [Live]
Led Zeppelin	BBC Sessions [Disc 1] [Live]
Led Zeppelin	Physical Graffiti [Disc 1]
Led Zeppelin	BBC Sessions [Disc 2] [Live]
Led Zeppelin	Coda
Led Zeppelin	Houses Of The Holy
Led Zeppelin	In Through The Out Door
Led Zeppelin	IV
Led Zeppelin	Led Zeppelin I
Led Zeppelin	Led Zeppelin II
Led Zeppelin	Led Zeppelin III
Led Zeppelin	Physical Graffiti [Disc 2]
Led Zeppelin	Presence
Led Zeppelin	The Song Remains The Same (Disc 1)
Led Zeppelin	The Song Remains The Same (Disc 2)
Legião Urbana	A TempestadeTempestade Ou O Livro Dos Dias
Legião Urbana	Mais Do Mesmo
Lenny Kravitz	Greatest Hits
Leonard Bernstein & New York Philharmonic	Great Performances - Barber's Adagio and Other Romantic Favorites for Strings
Les Arts Florissants & William Christie	Charpentier: Divertissements, Airs & Concerts
London Symphony Orchestra & Sir Charles Mackerras	Tchaikovsky: The Nutcracker
Los Hermanos	None
Los Lonely Boys	None
Lost	Lost, Season 3
Lost	Lost, Season 1
Lost	Lost, Season 2
Lost	LOST, Season 4
Luciana Souza/Romero Lubambo	Duos II
Luciano Pavarotti	Pavarotti's Opera Made Easy
Luiz Melodia	None
Lulu Santos	Lulu Santos - RCA 100 Anos De Música - Álbum 01
Lulu Santos	Lulu Santos - RCA 100 Anos De Música - Álbum 02
Marcos Valle	Chill: Brazil (Disc 1)
Marillion	Misplaced Childhood
Marisa Monte	Barulhinho Bom
Martin Roscoe	Szymanowski: Piano Works, Vol. 1
Marvin Gaye	Seek And Shall Find: More Of The Best (1963-1981)
Matisyahu	None
Maurizio Pollini	Beethoven Piano Sonatas: Moonlight & Pastorale
Mela Tenenbaum, Pro Musica Prague & Richard Kapp	Locatelli: Concertos for Violin, Strings and Continuo, Vol. 3
Men At Work	The Best Of Men At Work
Metallica	Garage Inc. (Disc 1)
Metallica	Black Album
Metallica	Garage Inc. (Disc 2)
Metallica	Kill 'Em All
Metallica	Load
Metallica	Master Of Puppets
Metallica	ReLoad
Metallica	Ride The Lightning
Metallica	St. Anger
Metallica	...And Justice For All
Michael Tilson Thomas & San Francisco Symphony	Prokofiev: Romeo & Juliet
Michael Tilson Thomas & San Francisco Symphony	Berlioz: Symphonie Fantastique
Michele Campanella	Liszt - 12 Études D'Execution Transcendante
Miles Davis	The Essential Miles Davis [Disc 1]
Miles Davis	The Essential Miles Davis [Disc 2]
Miles Davis	Miles Ahead
Milton Nascimento	Milton Nascimento Ao Vivo
Milton Nascimento	Minas
Milton Nascimento & Bebeto	None
Motörhead	Ace Of Spades
Motörhead & Girlschool	None
Mundo Livre S/A	None
Mônica Marianno	Demorou...
Mötley Crüe	Motley Crue Greatest Hits
Nando Reis	None
Nash Ensemble	Mozart: Chamber Music
Nação Zumbi	None
Nega Gizza	None
Ney Matogrosso	None
Nicolaus Esterhazy Sinfonia	The Best of Beethoven
Nirvana	From The Muddy Banks Of The Wishkah [Live]
Nirvana	Nevermind
O Rappa	Radio Brasil (O Som da Jovem Vanguarda) - Seleccao de Henrique Amaro
O Terço	Compositores
Olodum	Olodum
Orchestra of The Age of Enlightenment	Bach: The Brandenburg Concertos
Orchestre Révolutionnaire et Romantique & John Eliot Gardiner	Beethoven: Symhonies Nos. 5 & 6
Os Cariocas	None
Os Mutantes	Minha História
Os Paralamas Do Sucesso	Acústico MTV
Os Paralamas Do Sucesso	Arquivo II
Os Paralamas Do Sucesso	Arquivo Os Paralamas Do Sucesso
Otto	None
Otto Klemperer & Philharmonia Orchestra	Beethoven: Symphony No. 6 'Pastoral' Etc.
Ozzy Osbourne	Bark at the Moon (Remastered)
Ozzy Osbourne	Blizzard of Ozz
Ozzy Osbourne	Diary of a Madman (Remastered)
Ozzy Osbourne	No More Tears (Remastered)
Ozzy Osbourne	Tribute
Ozzy Osbourne	Speak of the Devil
Page & Plant	Walking Into Clarksdale
Passengers	Original Soundtracks 1
Paul D'Ianno	The Beast Live
Pearl Jam	Live On Two Legs [Live]
Pearl Jam	Pearl Jam
Pearl Jam	Riot Act
Pearl Jam	Ten
Pearl Jam	Vs.
Pedro Luís & A Parede	None
Pedro Luís E A Parede	None
Peter Tosh	None
Philharmonia Orchestra & Sir Neville Marriner	Mendelssohn: A Midsummer Night's Dream
Philip Glass Ensemble	Koyaanisqatsi (Soundtrack from the Motion Picture)
Pink Floyd	Dark Side Of The Moon
Planet Hemp	Os Cães Ladram Mas A Caravana Não Pára
Queen	Greatest Hits II
Queen	Greatest Hits I
Queen	News Of The World
R.E.M.	Green
R.E.M.	New Adventures In Hi-Fi
R.E.M.	The Best Of R.E.M.: The IRS Years
R.E.M. Feat. KRS-One	None
R.E.M. Feat. Kate Pearson	Out Of Time
Raimundos	Cesta Básica
Raul Seixas	Raul Seixas
Red Hot Chili Peppers	Blood Sugar Sex Magik
Red Hot Chili Peppers	By The Way
Red Hot Chili Peppers	Californication
Regina Spektor	None
Richard Marlow & The Choir of Trinity College, Cambridge	Allegri: Miserere
Rodox	None
Roger Norrington, London Classical Players	Purcell: The Fairy Queen
Royal Philharmonic Orchestra & Sir Thomas Beecham	Haydn: Symphonies 99 - 104
Rush	Retrospective I (1974-1980)
Sabotage E Instituto	None
Sandra De Sá	None
Santana	Supernatural
Santana	Santana - As Years Go By
Santana	Santana Live
Santana Feat. Dave Matthews	None
Santana Feat. Eagle-Eye Cherry	None
Santana Feat. Eric Clapton	None
Santana Feat. Everlast	None
Santana Feat. Lauryn Hill & Cee-Lo	None
Santana Feat. Maná	None
Santana Feat. Rob Thomas	None
Santana Feat. The Project G&B	None
Scholars Baroque Ensemble	Handel: The Messiah (Highlights)
Scorpions	20th Century Masters - The Millennium Collection: The Best of Scorpions
Sergei Prokofiev & Yuri Temirkanov	Prokofiev: Symphony No.1
Seu Jorge	None
Simply Red	None
Sir Georg Solti & Wiener Philharmoniker	Wagner: Favourite Overtures
Sir Georg Solti, Sumi Jo & Wiener Philharmoniker	Mozart Gala: Famous Arias
Skank	Maquinarama
Skank	O Samba Poconé
Smashing Pumpkins	Judas 0: B-Sides and Rarities
Smashing Pumpkins	Rotten Apples: Greatest Hits
Snow Patrol	None
Soundgarden	A-Sides
Spyro Gyra	Heart of the Night
Spyro Gyra	Morning Dance
Stereo Maracana	None
Stevie Ray Vaughan & Double Trouble	In Step
Stone Temple Pilots	Core
System Of A Down	Mezmerize
Temple of the Dog	Temple of the Dog
Terry Bozzio, Tony Levin & Steve Stevens	[1997] Black Light Syndrome
The 12 Cellists of The Berlin Philharmonic	South American Getaway
The Black Crowes	Live [Disc 1]
The Black Crowes	Live [Disc 2]
The Clash	The Singles
The Cult	Beyond Good And Evil
The Cult	Pure Cult: The Best Of The Cult (For Rockers, Ravers, Lovers & Sinners) [UK]
The Doors	The Doors
The Flaming Lips	None
The King's Singers	English Renaissance
The Office	The Office, Season 1
The Office	The Office, Season 2
The Office	The Office, Season 3
The Police	The Police Greatest Hits
The Posies	Every Kind of Light
The Postal Service	None
The Rolling Stones	Hot Rocks, 1964-1971 (Disc 1)
The Rolling Stones	No Security
The Rolling Stones	Voodoo Lounge
The Tea Party	Tangents
The Tea Party	Transmission
The Who	My Generation - The Very Best Of The Who
Tim Maia	Serie Sem Limite (Disc 1)
Tim Maia	Serie Sem Limite (Disc 2)
Titãs	Acústico
Titãs	Volume Dois
Ton Koopman	Bach: Toccata & Fugue in D Minor
Toquinho & Vinícius	Vinícius De Moraes - Sem Limite
U2	Achtung Baby
U2	All That You Can't Leave Behind
U2	B-Sides 1980-1990
U2	How To Dismantle An Atomic Bomb
U2	Pop
U2	Rattle And Hum
U2	The Best Of 1980-1990
U2	War
U2	Zooropa
U2	Instant Karma: The Amnesty International Campaign to Save Darfur
UB40	UB40 The Best Of - Volume Two [UK]
Van Halen	Diver Down
Van Halen	The Best Of Van Halen, Vol. I
Van Halen	Van Halen
Van Halen	Van Halen III
Various Artists	Axé Bahia 2001
Various Artists	Carnaval 2001
Various Artists	Sambas De Enredo 2001
Various Artists	Vozes do MPB
Velvet Revolver	Contraband
Vinicius, Toquinho & Quarteto Em Cy	None
Vinícius De Moraes	Vinicius De Moraes
Vinícius De Moraes & Baden Powell	None
Vinícius E Odette Lara	None
Vinícius E Qurteto Em Cy	None
Whitesnake	None
Wilhelm Kempff	Bach: Goldberg Variations
Xis	None
Yehudi Menuhin	Bartok: Violin & Viola Concertos
Yo-Yo Ma	Bach: The Cello Suites
Youssou N'Dour	None
Zeca Pagodinho	Ao Vivo [IMPORT]
The left join returns all rows from the artists table (or left table) and the matching rows from the albums table (or right table).

If a row from the left table doesn’t have a matching row in the right table, SQLite includes columns of the rows in the left table and NULL for the columns of the right table.

Exercise 2
1) Using two tables of your choice from chinook.db, demontrate RIGHT (OUTER) JOIN.
2) Using two tables of your choice from chinook.db, demontrate FULL (OUTER) JOIN.

Exercise 3
Write a Python program that creates a new database in a file called _myfirst.db containing a single table called Pressure, with a single field called reading, and inserts 100,000 random numbers between 10.0 and 25.0.

This lesson is only a brief introduction to SQL. If you want to become an expert, you may begin by reviewing all the sections in the website: https://www.w3schools.com/sql/default.asp. You can also switch over to the SQLlite tutorial at https://www.sqlitetutorial.net/.